{
  "level": 1,
  "zoo_size": "50x50",
  "resources": [1, 3, 4, 6, 9, 10, 11, 14, 15, 20, 21],
  "zoo": [
  [ 3,  3,  3,  3,  3,  4,  4,  4,  1,  1,  4,  4,  4,  6,  6,  6,  6,  6,  6,  6,  6,  6,  9,  9, 10, 10, 10, 10,  1, 11,  1, 14, 14, 14, 14, 15, 15, 15, 15, 15, 15, 15, 15, 21, 21,  3,  3,  3,  3,  3],
  [ 3,  3,  3,  3,  3,  4,  4,  4,  4,  4,  4,  4,  4,  6,  6,  6,  6,  6,  6,  6,  6,  6,  9,  9,  9, 10, 10, 10, 11, 11, 11, 14, 14, 14, 14, 15, 15, 15, 15, 15, 15, 15, 15, 21, 21,  3,  3,  3,  3,  3],
  [ 3,  3,  1,  3,  3,  4,  4,  4,  9,  9,  4,  4,  4,  6,  6,  6,  6,  6,  1,  1,  1,  1,  9,  9,  1,  1, 10, 10, 11, 11, 14, 14, 14, 14,  1, 15, 15, 10, 10, 10, 10, 15, 15, 21, 21,  3,  3,  1,  3,  3],
  [20, 20, 20,  1, 20, 20, 20,  1,  9,  9,  9, 11,  1,  6,  6,  6,  6,  6,  4,  4,  4,  1,  1,  4,  4,  4,  1, 10, 11, 11, 14, 14, 14, 14,  1, 15, 15,  1, 10, 10, 10, 15, 15, 21, 21, 21, 21, 21,  1,  1],
  [ 1, 20, 20, 20, 20, 20, 20, 20,  9,  9, 11, 11, 11,  6,  6,  6,  6,  6,  4,  4,  4,  4,  4,  4,  4,  4,  6,  6,  6,  6,  6,  6,  6,  6,  6, 21, 21,  9,  9, 10, 10,  1,  1, 21, 21, 21, 21, 21,  1,  1],
  [ 1,  1, 20,  1,  1, 20, 20, 20,  1,  1, 11, 11,  1,  6,  6,  6,  6,  6,  4,  4,  4,  1,  1,  4,  4,  4,  6,  6,  6,  6,  6,  6,  6,  6,  6, 21, 21,  9,  9,  9, 10,  9,  9, 21, 21,  3,  3,  3,  3,  3],
  [15, 15, 15, 15, 15, 15, 15, 15,  1,  1, 11, 11, 20, 20, 20,  1, 20, 20, 20, 10, 10, 10, 10,  1, 11,  1,  6,  6,  6,  6,  6, 14, 14, 14, 14, 21, 21,  9,  9,  1,  1,  9,  9,  9,  1,  3,  3,  3,  3,  3],
  [15, 15, 15, 15, 15, 15, 15, 15, 14, 14, 14, 14,  1, 20, 20, 20, 20, 20, 20, 20, 10, 10, 10, 11, 11, 11,  6,  6,  6,  6,  6, 14, 14, 14, 14, 21, 21, 21, 21, 21,  1,  9,  9,  1,  1,  3,  3,  1,  3,  3],
  [15, 15, 14, 14, 14, 14, 15, 15, 14, 14, 14, 14,  1,  1, 20,  1,  1, 20, 20, 20,  1, 10, 10, 11, 11,  1,  6,  6,  6,  6,  6, 21, 21,  1,  1, 21, 21, 21, 21, 21,  4,  4,  4,  1,  1,  4,  4,  4,  1,  1],
  [15, 15, 14, 14, 14, 14, 15, 15,  6,  6,  6,  6,  6,  6,  6,  6,  6,  1,  1,  1,  1,  1, 10, 11, 11,  1,  6,  6,  6,  6,  6, 21, 21,  1,  1, 21, 21,  1,  1,  1,  4,  4,  4,  4,  4,  4,  4,  4,  1,  1],
  [15, 15, 15, 15, 15, 15, 15, 15,  6,  6,  6,  6,  6,  6,  6,  6,  6, 20, 20, 20,  1, 20, 20, 20,  1,  3,  3,  3,  3,  3,  1, 21, 21,  1,  1,  1,  1,  1,  1,  1,  4,  4,  4,  1,  1,  4,  4,  4,  1,  1],
  [15, 15, 15, 15, 15, 15, 15, 15,  6,  6,  6,  6,  6, 14, 14, 14, 14,  1, 20, 20, 20, 20, 20, 20, 20,  3,  3,  3,  3,  3,  1, 21, 21, 21, 21, 21,  4,  4,  4,  1,  1,  4,  4,  4, 10, 10, 10, 10,  1,  1],
  [15, 15,  1, 11,  1,  1, 15, 15,  6,  6,  6,  6,  6, 14, 14, 14, 14,  1,  1, 20,  1,  1, 20, 20, 20,  3,  3,  1,  3,  3,  1, 21, 21, 21, 21, 21,  4,  4,  4,  4,  4,  4,  4,  4,  1, 10, 10, 10,  1,  1],
  [15, 15, 11, 11, 11,  1, 15, 15,  6,  6,  6,  6,  6,  6,  6,  6,  6,  6,  6,  6,  6,  6, 15, 15, 15, 15, 15, 15, 15, 15,  1, 21, 21,  1,  1,  1,  4,  4,  4, 21, 21,  4,  4,  4,  9,  9, 10, 10,  1,  1],
  [ 1,  1, 11, 11,  1,  1,  1,  1,  6,  6,  6,  6,  6,  6,  6,  6,  6,  6,  6,  6,  6,  6, 15, 15, 15, 15, 15, 15, 15, 15, 20, 20, 20,  1, 20, 20, 20,  1,  1, 21, 21,  1,  1,  1,  9,  9,  9, 10, 11,  1],
  [ 9,  9, 11, 11,  3,  3,  3,  3,  3, 10, 10, 10, 10,  6,  6,  6,  6,  6,  1,  1,  1,  1, 15, 15,  1,  1,  1,  1, 15, 15,  1, 20, 20, 20, 20, 20, 20, 20,  1, 21, 21,  1,  1,  1,  9,  9,  1, 11, 11, 11],
  [ 9,  9,  9,  1,  3,  3,  3,  3,  3,  1, 10, 10, 10,  6,  6,  6,  6,  6,  1,  4,  4,  4, 15, 15,  4,  4,  4,  1, 15, 15,  1,  1, 20,  1,  1, 20, 20, 20,  1, 21, 21, 21, 21, 21,  1,  1,  1, 11, 11,  1],
  [ 9,  9,  1,  1,  3,  3,  1,  3,  3, 21, 21, 10, 10,  6,  6,  6,  6,  6,  1,  4,  4,  4,  4,  4,  4,  4,  4,  6,  6,  6,  6,  6,  6,  6,  6,  6,  1,  1,  1, 21, 21, 21, 21, 21,  1,  1,  1, 11, 11,  1],
  [15, 15, 15, 15, 15, 15, 15, 15,  1, 21, 21,  1, 10,  6,  6,  6,  6,  6,  1,  4,  4,  4,  1,  1,  4,  4,  4,  6,  6,  6,  6,  6,  6,  6,  6,  6,  1,  1,  1, 21, 21, 20, 20, 20,  1, 20, 20, 20,  1,  1],
  [15, 15, 15, 15, 15, 15, 15, 15,  1, 21, 21,  1,  1,  1,  3,  3,  3,  3,  3,  4,  4,  4,  1,  1,  4,  4,  4,  6,  6,  6,  6,  6,  6,  6,  6,  6,  6,  6,  6,  6,  6,  1, 20, 20, 20, 20, 20, 20, 20,  1],
  [15, 15, 10, 10, 10, 10, 15, 15,  1, 21, 21, 21, 21, 21,  3,  3,  3,  3,  3,  4,  4,  4,  4,  4,  4,  4,  4,  6,  6,  6,  6,  6,  6,  6,  6,  6,  6,  6,  6,  6,  6, 11,  1, 20, 21, 21, 20, 20, 20,  1],
  [15, 15,  1, 10, 10, 10, 15, 15,  1, 21, 21, 21, 21, 21,  3,  3,  1,  3,  3,  4,  4,  4,  1,  1,  4,  4,  4,  6,  6,  6,  6,  6,  6,  6,  6,  6,  6,  9,  9,  1, 11, 11, 11,  1, 21, 21, 14, 14, 14, 14],
  [ 1,  1,  1,  1, 10, 10,  1, 11,  1, 21, 21, 15, 15, 15, 15, 15, 15, 15, 15, 20, 20, 20,  1, 20, 20, 20,  1,  6,  6,  6,  6,  6,  6,  6,  6,  6,  6,  9,  9,  9, 11, 11,  1,  1, 21, 21, 14, 14, 14, 14],
  [ 3,  3,  3,  3,  3, 10, 11, 11, 11,  1,  1, 15, 15, 15, 15, 15, 15, 15, 15,  1, 20, 20, 20, 20, 20, 20, 20, 10, 10, 10, 10,  1,  6,  6,  6,  6,  6,  9,  9,  1, 11, 11, 21, 21, 21, 21, 21, 21, 21,  1],
  [ 3,  3,  3,  3,  3,  1, 11, 11,  1,  1,  1, 15, 15,  1,  1,  1,  1, 15, 15,  1,  1, 20,  1,  1, 20, 20, 20,  1, 10, 10, 10,  1,  6,  6,  6,  6,  6,  1,  1,  9,  9,  1, 21, 21, 21, 21, 21, 21, 21,  1],
  [ 3,  3,  1,  3,  3,  1, 11, 11,  4,  4,  4, 15, 15,  4,  4,  4,  1, 15, 15,  6,  6,  6,  6,  6,  6,  6,  6,  6,  1, 10, 10, 15, 15, 15, 15, 15, 15, 15, 15,  9,  9,  9, 21, 21, 21, 21, 10, 10, 10, 10],
  [20, 20, 20,  1, 20, 20, 20,  1,  4,  4,  4,  4,  4,  4,  4,  4,  1, 11,  1,  6,  6,  6,  6,  6,  6,  6,  6,  6,  1,  1, 10, 15, 15, 15, 15, 15, 15, 15, 15,  9,  9,  1, 21, 21, 21, 21, 21, 10, 10, 10],
  [ 1, 20, 20, 20, 20, 20, 20, 20,  4,  4,  4,  1,  1,  4,  4,  4, 11, 11, 11,  6,  6,  6,  6,  6,  3,  3,  3,  3,  3,  1,  1, 15, 15, 14, 14, 14, 14, 15, 15,  1,  1,  1, 21, 21, 21, 21, 21,  1, 10, 10],
  [ 1,  1, 20,  1,  1, 20, 20, 20,  4,  4,  4,  1,  1,  4,  4,  4, 11, 11,  1,  6,  6,  6,  6,  6,  3,  3,  3,  3,  3,  1,  1, 15, 15, 14, 14, 14, 14, 15, 15,  1,  1,  1, 21, 21,  1,  1,  9,  9,  1, 10],
  [15, 15, 15, 15, 15, 15, 15, 15,  4,  4,  4,  4,  4,  4,  4,  4, 11, 11,  1,  6,  6,  6,  6,  6,  3,  3,  1,  3,  3,  6,  6,  6,  6,  6,  6,  6,  6,  6, 20, 20, 20,  1, 20, 20, 20,  1,  9,  9,  9,  1],
  [15, 15, 15, 15, 15, 15, 15, 15,  4,  4,  4, 21, 21,  4,  4,  4,  1,  1,  1,  6,  6,  6,  6,  6,  3,  3,  3,  3,  3,  6,  6,  6,  6,  6,  6,  6,  6,  6,  1, 20, 20, 20, 20, 20, 20, 20,  9,  9, 11,  1],
  [15, 15, 10, 10, 10, 10, 15, 15,  9,  9,  1, 21, 21,  1,  1,  1,  4,  4,  4,  1,  1,  4,  4,  4,  3,  3,  3,  3,  3,  6,  6,  6,  6,  6,  1,  1,  1,  1,  1,  1, 20,  1,  1, 20, 20, 20,  1, 11, 11, 11],
  [15, 15,  1, 10, 10, 10, 15, 15,  9,  9,  9, 21, 21,  1,  1,  1,  4,  4,  4,  4,  4,  4,  4,  4,  3,  3,  1,  3,  3,  6,  6,  6,  6,  6,  6,  6,  6,  6,  6,  6,  6,  6,  6, 14, 14, 14, 14, 11, 11,  1],
  [ 1,  1,  1,  1, 10, 10,  1,  1,  9,  9,  1, 21, 21, 21, 21, 21,  4,  4,  4,  1,  1,  4,  4,  4, 21, 21,  1,  1,  1,  6,  6,  6,  6,  6,  6,  6,  6,  6,  6,  6,  6,  6,  6, 14, 14, 14, 14, 11, 11,  1],
  [ 1,  1, 20, 20, 20, 10, 20, 20, 20,  1,  1, 21, 21, 21, 21, 21, 15, 15, 15, 15, 15, 15, 15, 15, 21, 21,  1,  1,  1,  6,  6,  6,  6,  6,  6,  6,  6,  6,  6,  3,  3,  3,  3,  3,  1, 10, 10, 10, 10,  1],
  [ 1,  1,  1, 20, 20, 20, 20, 20, 20, 20,  1, 21, 21, 11,  1,  1, 15, 15, 15, 15, 15, 15, 15, 15, 21, 21,  1,  1,  1, 14, 14, 14, 14,  1,  6,  6,  6,  6,  6,  3,  3,  3,  3,  3,  1,  1, 10, 10, 10,  1],
  [ 1,  1,  1,  1, 20,  1,  1, 20, 20, 20,  1,  1, 11, 11, 11,  1, 15, 15,  1,  1,  1,  1, 15, 15, 21, 21, 21, 21, 21, 14, 14, 14, 14,  1,  6,  6,  6,  6,  6,  3,  3,  1,  3,  3,  1,  1,  1, 10, 10,  1],
  [ 4,  4,  4,  1,  1,  4,  4,  4, 21, 21,  1,  1, 11, 11,  1,  1, 15, 15,  1,  1,  1,  1, 15, 15, 21, 21, 21, 21, 21,  1,  1,  1,  1,  1,  6,  6,  6,  6,  6,  6,  6,  6,  6,  6,  6,  6,  6,  6, 10,  1],
  [ 4,  4,  4,  4,  4,  4,  4,  4, 21, 21,  1,  1, 11, 11, 15, 15, 15, 15, 15, 15, 15, 15,  1,  1, 21, 21, 20, 20, 20,  1, 20, 20, 20,  1,  1,  1,  1,  1,  1,  6,  6,  6,  6,  6,  6,  6,  6,  6,  1,  1],
  [ 4,  4,  4,  1,  1,  4,  4,  4, 21, 21,  1,  1,  1,  1, 15, 15, 15, 15, 15, 15, 15, 15,  1,  1,  1,  1,  1, 20, 20, 20, 20, 20, 20, 20,  1,  1,  1,  1,  1,  6,  6,  6,  6,  6,  1,  1,  1,  1,  1,  1],
  [ 1,  1,  1,  1,  1,  1,  1,  1, 21, 21, 21, 21, 21,  1, 15, 15,  1,  1,  1,  1, 15, 15,  1,  1,  1,  1,  1,  1, 20,  1,  1, 20, 20, 20,  1,  1,  1,  1,  1,  6,  6,  6,  6,  6,  1,  1,  1,  1,  1,  1],
  [ 1,  1,  1,  1,  1,  1,  1,  1, 21, 21, 21, 21, 21,  1, 15, 15,  1,  1,  1,  1, 15, 15,  1,  1,  1,  1,  1,  1,  1,  1,  1,  1,  1,  1,  1,  1,  1,  1,  1,  6,  6,  6,  6,  6,  1,  1,  1,  1,  1,  1],
  [ 1,  1,  1,  1,  1,  1,  1,  1, 21, 21,  1,  1,  1,  1,  1,  1,  1,  1,  1,  1,  1,  1,  1,  1,  1,  1,  1,  1,  1,  1,  1,  1,  1,  1,  1,  1,  1,  1,  1,  6,  6,  6,  6,  6,  1,  1,  1,  1,  1,  1],
  [ 1,  1,  1,  1,  1,  1,  1,  1,  1,  1,  1,  1,  1,  1,  1,  1,  1,  1,  1,  1,  1,  1,  1,  1,  1,  1,  1,  1,  1,  1,  1,  1,  1,  1,  1,  1,  1,  1,  1,  1,  1,  1,  1,  1,  1,  1,  1,  1,  1,  1],
  [ 1,  1,  1,  1,  1,  1,  1,  1,  1,  1,  1,  1,  1,  1,  1,  1,  1,  1,  1,  1,  1,  1,  1,  1,  1,  1,  1,  1,  1,  1,  1,  1,  1,  1,  1,  1,  1,  1,  1,  1,  1,  1,  1,  1,  1,  1,  1,  1,  1,  1],
  [ 1,  1,  1,  1,  1,  1,  1,  1,  1,  1,  1,  1,  1,  1,  1,  1,  1,  1,  1,  1,  1,  1,  1,  1,  1,  1,  1,  1,  1,  1,  1,  1,  1,  1,  1,  1,  1,  1,  1,  1,  1,  1,  1,  1,  1,  1,  1,  1,  1,  1],
  [ 1,  1,  1,  1,  1,  1,  1,  1,  1,  1,  1,  1,  1,  1,  1,  1,  1,  1,  1,  1,  1,  1,  1,  1,  1,  1,  1,  1,  1,  1,  1,  1,  1,  1,  1,  1,  1,  1,  1,  1,  1,  1,  1,  1,  1,  1,  1,  1,  1,  1],
  [ 1,  1,  1,  1,  1,  1,  1,  1,  1,  1,  1,  1,  1,  1,  1,  1,  1,  1,  1,  1,  1,  1,  1,  1,  1,  1,  1,  1,  1,  1,  1,  1,  1,  1,  1,  1,  1,  1,  1,  1,  1,  1,  1,  1,  1,  1,  1,  1,  1,  1],
  [ 1,  1,  1,  1,  1,  1,  1,  1,  1,  1,  1,  1,  1,  1,  1,  1,  1,  1,  1,  1,  1,  1,  1,  1,  1,  1,  1,  1,  1,  1,  1,  1,  1,  1,  1,  1,  1,  1,  1,  1,  1,  1,  1,  1,  1,  1,  1,  1,  1,  1],
  [ 1,  1,  1,  1,  1,  1,  1,  1,  1,  1,  1,  1,  1,  1,  1,  1,  1,  1,  1,  1,  1,  1,  1,  1,  1,  1,  1,  1,  1,  1,  1,  1,  1,  1,  1,  1,  1,  1,  1,  1,  1,  1,  1,  1,  1,  1,  1,  1,  1,  1]
]
}
